########
#  PX O#
#      #
# O X  #
#      #
########